1111111111
100E111001
1P101100C1
1000000001
1111001111
1111111111