111111111
1000P0001
100000001
1CC1E1CC1
111111111