1111111
100E001
1P100C1
1111111