111111111111111
100000000000001
111011011101101
1C0001E11100111
111100011110P11
111111111111111